0000000000000000000000-
2200111011133333300000-
0200101010010100300000-
0200122222222200300000-
0222121010010200300000-
0102121010010200300000-
0102121010010200300000-
0112221110011222222222-
000000000000000000000